date,stations_nb,ready,renting,returning,not_installed,not_renting,not_returning
1709253462,184,161,163,169,0,21,2
1709257489,184,167,167,171,0,17,0
1709259510,184,162,165,171,0,19,3
1709262646,184,156,160,169,0,24,4
1709266209,184,157,161,167,0,23,4
1709269675,184,155,159,168,0,25,4
1709273397,184,161,164,171,0,20,3
1709276818,184,164,167,172,0,17,3
1709280551,184,160,163,170,0,21,3
1709284149,184,162,165,168,0,19,3
1709287643,184,162,164,172,0,20,2
1709291155,184,169,171,173,0,13,2
1709295156,184,166,169,174,0,15,3
1709299497,184,171,173,178,0,11,2
1709301993,184,167,170,178,0,14,3
1709305666,184,160,163,177,0,21,3
1709309306,184,171,172,178,0,12,1
1709312949,184,171,172,178,0,12,1
1709316564,184,170,173,175,0,11,3
1709319982,184,175,176,173,0,8,1
1709323674,184,170,171,173,0,13,1
1709327270,184,169,171,172,0,13,2
1709330743,184,173,173,174,0,11,0
1709334368,184,168,169,173,0,15,1
1709339557,184,166,168,173,0,16,2
1709343395,184,166,169,175,0,15,3
1709345466,184,161,164,175,0,20,3
1709348840,184,157,161,174,0,23,4
1709352492,184,157,161,174,0,23,4
1709356023,184,157,161,174,0,23,4
1709359765,184,156,162,172,0,22,6
1709363142,184,160,164,171,0,20,4
1709366890,184,162,167,172,0,17,5
1709370361,184,168,170,173,0,14,2
1709373995,184,166,169,172,0,15,3
1709377524,184,171,172,171,0,12,1
1709381494,184,163,165,172,0,19,2
1709384756,184,163,163,173,0,21,0
1709388383,184,160,161,172,0,23,1
1709391987,184,165,166,172,0,18,1
1709395708,184,168,169,171,0,15,1
1709399097,184,173,174,172,0,10,1
1709402913,184,169,171,172,0,13,2
1709406297,184,167,171,169,0,13,4
1709409983,184,164,166,168,0,18,2
1709413543,184,165,167,166,0,17,2
1709417135,184,167,168,166,0,16,1
1709420815,184,169,170,168,0,14,1
1709426152,184,174,175,169,0,9,1
1709430078,184,175,176,171,0,8,1
1709432126,184,174,174,171,0,10,0
1709435255,184,172,173,171,0,11,1
1709438963,184,170,173,170,0,11,3
1709442428,184,170,173,170,0,11,3
1709446170,184,171,174,170,0,10,3
1709449574,184,172,174,170,0,10,2
1709453379,184,174,176,170,0,8,2
1709456848,184,171,173,171,0,11,2
1709460487,184,170,171,171,0,13,1
1709463892,184,168,169,171,0,15,1
1709467911,184,167,168,171,0,16,1
1709471195,184,167,168,170,0,16,1
1709474787,184,168,170,170,0,14,2
1709478351,184,165,168,170,0,16,3
1709482040,184,166,168,173,0,16,2
1709485511,184,169,172,171,0,12,3
1709489262,184,172,175,173,0,9,3
1709492671,184,171,173,173,0,11,2
1709496474,184,173,173,174,0,11,0
1709499973,184,176,176,173,0,8,0
1709503534,184,174,175,173,0,9,1
1709507187,184,168,170,171,0,14,2
1709512466,184,166,168,171,0,16,2
1709517376,184,166,168,171,0,16,2
1709520988,184,167,169,171,0,15,2
1709523568,184,168,170,171,0,14,2
1709526971,184,171,173,170,0,11,2
1709530869,184,168,170,170,0,14,2
1709535293,184,164,167,171,0,17,3
1709538773,184,156,158,171,0,26,2
1709544464,184,153,155,171,0,29,2
1709551016,185,158,163,170,0,22,5
1709554735,185,156,157,172,0,28,1
1709557753,185,163,163,170,0,22,0
1709561171,185,160,160,172,0,25,0
1709564902,185,156,158,173,0,27,2
1709568600,185,159,161,175,0,24,2
1709572025,185,169,170,176,0,15,1
1709575752,185,165,170,172,0,15,5
1709579135,185,166,167,174,0,18,1
1709582821,185,164,164,172,0,21,0
1709586443,185,166,168,170,0,17,2
1709589973,185,161,163,170,0,22,2
1709593656,185,166,167,168,0,18,1
1709598812,185,164,168,165,0,17,4
1709602705,185,167,168,167,0,17,1
1709604779,185,165,167,167,0,18,2
1709608059,185,164,166,167,0,19,2
1709611768,185,166,168,167,0,17,2
1709615215,185,165,167,167,0,18,2
1709618944,185,166,169,167,0,16,3
1709622414,185,165,166,173,0,19,1
1709626203,185,167,170,169,0,15,3
1709629650,185,158,159,167,0,26,1
1709633295,185,152,157,166,0,28,5
1709636858,185,159,160,173,0,25,1
1709640770,185,163,165,173,0,20,2
1709644036,185,161,162,174,0,23,1
1709647578,185,161,163,174,0,22,2
1709651211,185,166,167,173,0,18,1
1709654909,185,167,168,172,0,17,1
1709658488,185,165,166,173,0,19,1
1709662096,185,164,165,170,0,20,1
1709665522,185,164,166,169,0,19,2
1709669240,185,164,170,167,0,15,6
1709672803,185,162,165,167,0,20,3
1709676396,185,162,166,168,0,19,4
1709679985,185,162,163,169,0,22,1
1709685226,185,156,160,167,0,25,4
1709689149,185,158,163,164,0,22,5
1709691200,185,160,164,166,0,21,4
1709694450,185,159,165,164,0,20,6
1709698098,185,158,164,164,0,21,6
1709701593,185,161,165,166,0,20,4
1709705425,185,162,167,165,0,18,5
1709708801,185,166,167,171,0,18,1
1709712628,185,157,160,168,0,25,3
1709716046,185,150,153,167,0,32,3
1709719682,185,154,158,171,0,27,4
1709723188,185,150,154,175,0,31,4
1709727246,185,166,167,182,0,18,1
1709730388,185,168,169,181,0,16,1
1709733961,185,166,167,182,0,18,1
1709737713,185,174,174,181,0,11,0
1709741316,185,167,169,178,0,16,2
1709744829,185,168,169,175,0,16,1
1709748565,185,170,170,171,0,15,0
1709751859,185,165,166,172,0,19,1
1709755573,185,167,169,171,0,16,2
1709759225,185,164,167,168,0,18,3
1709762784,185,166,168,171,0,17,2
1709766434,185,164,166,169,0,19,2
1709771246,185,162,164,167,0,21,2
1709774678,185,157,160,168,0,25,3
1709777201,185,158,159,170,0,26,1
1709780800,185,158,160,169,0,25,2
1709784527,185,158,160,168,0,25,2
1709787992,185,158,159,169,0,26,1
1709791832,185,167,167,171,0,18,0
1709795176,185,168,170,170,0,15,2
1709798839,185,162,164,168,0,21,2
1709802375,185,165,165,170,0,20,0
1709806055,185,166,166,171,0,19,0
1709809574,185,168,168,174,0,17,0
1709813566,185,160,161,174,0,24,1
1709816803,185,161,167,173,0,18,6
1709820439,185,160,161,176,0,24,1
1709824018,185,168,169,177,0,16,1
1709827683,185,166,166,178,0,19,0
1709831237,185,164,165,175,0,20,1
1709834942,185,165,165,174,0,20,0
1709838359,185,161,161,174,0,24,0
1709842017,185,162,162,171,0,23,0
1709845609,185,162,163,172,0,22,1
1709849198,185,168,168,172,0,17,0
1709852855,185,167,168,175,0,17,1
1709858040,185,168,168,174,0,17,0
1709861903,185,167,168,173,0,17,1
1709864050,185,163,166,172,0,19,3
1709867267,185,166,170,171,0,15,4
1709870916,185,167,170,171,0,15,3
1709874445,185,168,171,172,0,14,3
1709878153,185,165,168,172,0,17,3
1709881712,185,172,173,175,0,12,1
1709885340,185,169,170,175,0,15,1
1709888847,185,166,166,176,0,19,0
1709892518,185,169,172,173,0,13,3
1709895924,185,171,173,173,0,12,2
1709899947,185,169,169,176,0,16,0
1709903201,185,173,173,177,0,12,0
1709906825,185,177,177,177,0,8,0
1709910449,185,176,177,178,0,8,1
1709914102,185,178,179,178,0,6,1
1709917597,185,182,182,179,0,3,0
1709921351,185,171,172,177,0,13,1
1709924793,185,173,173,176,0,12,0
1709928421,185,174,174,176,0,11,0
1709932018,185,170,170,175,0,15,0
1709935694,185,170,171,175,0,14,1
1709939290,185,171,174,173,0,11,3
1709944354,185,168,171,173,0,14,3
1709948096,185,165,167,173,0,18,2
1709950205,185,162,164,173,0,21,2
1709953819,185,167,170,172,0,15,3
1709957287,185,165,167,171,0,18,2
1709960937,185,168,172,170,0,13,4
1709964620,185,167,171,171,0,14,4
1709967939,185,167,170,173,0,15,3
1709971713,185,169,170,177,0,15,1
1709975306,185,174,177,174,0,8,3
1709978829,185,170,172,174,0,13,2
1709982349,185,177,177,176,0,8,0
1709986252,185,170,172,175,0,13,2
1709989571,185,176,177,175,0,8,1
1709993257,185,177,180,173,0,5,3
1709996754,185,179,182,174,0,3,3
1710000435,185,179,182,174,0,3,3
1710003902,185,176,179,173,0,6,3
1710007674,185,176,180,172,0,5,4
1710011049,185,176,182,171,0,3,6
1710014800,185,179,182,173,0,3,3
1710018439,185,179,181,173,0,4,2
1710021998,185,176,178,174,0,7,2
1710025648,185,175,176,174,0,9,1
1710030982,185,175,175,175,0,10,0
1710034968,185,171,171,175,0,14,0
1710037100,185,173,173,175,0,12,0
1710040075,185,173,173,175,0,12,0
1710043694,185,171,171,175,0,14,0
1710047190,185,171,171,175,0,14,0
1710050899,185,174,174,175,0,11,0
1710054430,185,169,172,174,0,13,3
1710058144,185,169,171,175,0,14,2
1710061582,185,169,170,174,0,15,1
1710065189,185,162,164,170,0,21,2
1710068761,185,162,164,172,0,21,2
1710072665,185,162,166,174,0,19,4
1710076052,185,153,156,171,0,29,3
1710079593,185,152,155,169,0,30,3
1710083162,185,159,160,171,0,25,1
1710086887,185,161,161,174,0,24,0
1710090430,185,165,167,174,0,18,2
1710094060,185,161,165,170,0,20,4
1710097470,185,163,165,171,0,20,2
1710101215,185,156,159,167,0,26,3
1710104740,185,158,163,167,0,22,5
1710108454,185,164,167,172,0,18,3
1710112012,185,159,163,170,0,22,4
1710117317,185,159,164,168,0,21,5
1710121178,185,157,161,170,0,24,4
1710123299,185,158,162,171,0,23,4
1710126549,185,159,164,170,0,21,5
1710130162,185,165,169,170,0,16,4
1710133626,185,165,168,171,0,17,3
1710137368,185,165,168,171,0,17,3
1710140865,185,157,160,172,0,25,3
1710144621,185,154,155,172,0,30,1
1710148100,185,151,155,167,0,30,4
1710151779,185,150,155,166,0,30,5
1710155217,185,163,164,169,0,21,1
1710159150,185,163,165,172,0,20,2
1710162415,185,161,163,170,0,22,2
1710165983,185,165,166,172,0,19,1
1710169676,185,165,166,174,0,19,1
1710173307,185,167,170,174,0,15,3
1710176821,185,162,163,174,0,22,1
1710180548,185,164,166,171,0,19,2
1710183958,185,166,169,170,0,16,3
1710187733,185,166,167,171,0,18,1
1710191233,185,164,165,170,0,20,1
1710194794,185,165,169,168,0,16,4
1710198471,185,160,162,168,0,23,2
1710203589,185,164,166,167,0,19,2
1710207509,185,165,166,167,0,19,1
1710209580,185,166,167,167,0,18,1
1710212892,185,168,169,167,0,16,1
1710216600,185,167,168,167,0,17,1
1710220124,185,167,168,167,0,17,1
1710223773,185,166,168,165,0,17,2
1710227209,185,154,158,166,0,27,4
1710230933,185,153,155,168,0,30,2
1710234531,185,157,159,167,0,26,2
1710238052,185,152,153,169,0,32,1
1710241538,185,155,157,167,0,28,2
1710245539,185,161,163,167,0,22,2
1710248833,185,160,162,168,0,23,2
1710252399,185,162,165,172,0,20,3
1710255998,185,162,163,177,0,22,1
1710259755,185,161,163,174,0,22,2
1710263240,185,163,164,175,0,21,1
1710266937,185,156,160,172,0,25,4
1710270354,185,156,161,166,0,24,5
1710274041,185,160,162,168,0,23,2
1710277632,185,155,157,170,0,28,2
1710281190,185,159,162,168,0,23,3
1710284870,185,156,160,167,0,25,4
1710290017,185,156,158,164,0,27,2
1710294093,185,154,156,164,0,29,2
1710296127,185,153,155,164,0,30,2
1710299346,185,157,159,165,0,26,2
1710302899,185,158,159,165,0,26,1
1710306450,185,154,156,165,0,29,2
1710310188,185,154,155,166,0,30,1
1710313600,185,152,154,170,0,31,2
1710317322,185,146,151,171,0,34,5
1710320857,185,147,149,172,0,36,2
1710324486,185,155,157,173,0,28,2
1710328053,185,151,154,174,0,31,3
1710331993,185,159,161,175,0,24,2
1710335193,185,160,162,175,0,23,2
1710338798,185,157,158,179,0,27,1
1710342465,185,160,160,178,0,25,0
1710346095,185,162,164,178,0,21,2
1710350909,185,153,154,178,0,31,1
1710353343,185,154,158,175,0,27,4
1710356785,185,152,153,175,0,32,1
1710360435,185,157,159,172,0,26,2
1710364087,185,157,159,176,0,26,2
1710367584,185,160,161,178,0,24,1
1710371234,185,154,156,176,0,29,2
1710376381,185,158,161,173,0,24,3
1710380356,185,158,161,173,0,24,3
1710382395,185,160,163,174,0,22,3
1710385671,185,163,165,174,0,20,2
1710389315,185,166,168,174,0,17,2
1710392804,185,164,166,175,0,19,2
1710396573,185,159,162,174,0,23,3
1710400135,185,153,154,176,0,31,1
1710403765,185,157,160,173,0,25,3
1710407240,185,147,150,173,0,35,3
1710410856,185,150,152,172,0,33,2
1710414358,185,153,155,175,0,30,2
1710418423,185,155,158,175,0,27,3
1710421652,185,160,161,178,0,24,1
1710430892,185,159,159,180,0,26,0
1710432557,185,157,157,181,0,28,0
1710435985,185,157,160,176,0,25,3
1710439711,185,158,161,174,0,24,3
1710443150,185,153,155,173,0,30,2
1710446861,185,155,157,172,0,28,2
1710450420,185,149,150,170,0,35,1
1710453977,185,155,157,170,0,28,2
1710457593,185,161,164,170,0,21,3
1710462828,185,153,156,171,0,29,3
1710466809,185,154,156,171,0,29,2
1710468870,185,157,158,172,0,27,1
1710472106,185,159,161,171,0,24,2
1710475779,185,156,161,170,0,24,5
1710479299,185,155,160,171,0,25,5
1710482979,185,156,160,173,0,25,4
1710486463,185,155,157,171,0,28,2
1710490185,185,155,155,177,0,30,0
1710493629,185,152,153,173,0,32,1
1710497217,185,146,148,173,0,37,2
1710500735,185,155,156,177,0,29,1
1710504739,183,163,165,175,0,18,2
1710508063,182,164,164,175,0,18,0
1710511632,182,163,163,176,0,19,0
1710515238,182,161,162,176,0,20,1
1710518933,182,162,164,176,0,18,2
1710522416,182,163,165,174,0,17,2
1710526210,182,155,157,172,0,25,2
1710529588,182,158,160,171,0,22,2
1710533303,182,153,154,173,0,28,1
1710536747,182,156,158,171,0,24,2
1710540428,182,154,156,173,0,26,2
1710544047,182,157,160,171,0,22,3
1710549134,182,165,166,171,0,16,1
1710553022,182,163,164,172,0,18,1
1710555157,182,160,162,171,0,20,2
1710558494,182,156,158,170,0,24,2
1710562073,182,157,159,168,0,23,2
1710565592,182,157,158,168,0,24,1
1710569325,182,155,157,169,0,25,2
1710572817,182,164,165,171,0,17,1
1710576526,182,166,171,170,0,11,5
1710579978,182,165,168,173,0,14,3
1710583620,182,158,163,173,0,19,5
1710587074,182,154,157,175,0,25,3
1710591180,182,154,154,173,0,28,0
1710594407,182,139,140,171,0,42,1
1710597945,182,136,139,167,0,43,3
1710601546,182,136,137,167,0,45,1
1710605238,182,137,137,173,0,45,0
1710608749,182,149,149,176,0,33,0
1710612530,182,154,155,177,0,27,1
1710615848,182,151,154,172,0,28,3
1710619619,182,157,158,172,0,24,1
1710623136,182,161,163,174,0,19,2
1710626810,182,159,159,175,0,23,0
1710630455,182,152,154,175,0,28,2
1710635782,182,156,160,174,0,22,4
1710639762,182,154,158,173,0,24,4
1710641709,182,158,159,172,0,23,1
1710644829,182,153,156,171,0,26,3
1710648532,182,151,151,171,0,31,0
1710652080,182,155,156,171,0,26,1
1710655718,182,160,160,172,0,22,0
1710659175,182,160,162,171,0,20,2
1710662910,182,166,166,172,0,16,0
1710666372,182,154,156,174,0,26,2
1710669993,182,150,151,176,0,31,1
1710673574,182,151,152,175,0,30,1
1710677503,182,157,157,174,0,25,0
1710680907,182,148,148,173,0,34,0
1710684335,182,146,146,174,0,36,0
1710688049,182,135,136,174,0,46,1
1710691644,182,143,143,176,0,39,0
1710695143,182,146,148,173,0,34,2
1710698855,182,158,159,175,0,23,1
1710702319,182,161,161,175,0,21,0
1710706022,182,160,161,174,0,21,1
1710709664,182,148,151,171,0,31,3
1710713186,182,152,155,168,0,27,3
1710716889,182,148,151,168,0,31,3
1710722087,182,148,151,169,0,31,3
1710726001,182,148,151,169,0,31,3
1710728035,182,150,153,169,0,29,3
1710731336,182,146,149,168,0,33,3
1710734912,182,147,150,169,0,32,3
1710738520,182,146,151,168,0,31,5
1710742219,182,139,144,170,0,38,5
1710745684,182,139,141,173,0,41,2
1710749367,182,143,143,174,0,39,0
1710752831,185,139,140,175,0,45,1
1710756502,185,148,149,174,0,36,1
1710760000,185,145,149,174,0,36,4
1710763974,185,154,157,179,0,28,3
1710767243,185,154,155,179,0,30,1
1710770871,185,158,158,182,0,27,0
1710774412,185,158,159,180,0,26,1
1710778165,185,154,157,180,0,28,3
1710781647,185,159,159,182,0,26,0
1710785342,185,153,155,180,0,30,2
1710788786,185,161,163,179,0,22,2
1710792407,185,158,161,176,0,24,3
1710796074,185,164,165,177,0,20,1
1710799630,185,160,160,179,0,25,0
1710803282,185,160,161,177,0,24,1
1710808424,185,158,160,176,0,25,2
1710812368,185,153,156,175,0,29,3
1710814453,185,158,160,176,0,25,2
1710817689,185,158,161,174,0,24,3
1710821333,185,159,161,174,0,24,2
1710824887,185,158,162,174,0,23,4
1710828569,185,159,160,178,0,25,1
1710832045,185,154,156,178,0,29,2
1710835768,185,147,150,175,0,35,3
1710839215,185,145,146,175,0,39,1
1710842855,185,158,159,173,0,26,1
1710846421,185,144,145,177,0,40,1
1710850387,185,156,159,176,0,26,3
1710853676,185,153,155,176,0,30,2
1710857238,185,162,165,175,0,20,3
1710860885,185,165,165,180,0,20,0
1710864579,185,157,157,180,0,28,0
1710868031,185,150,150,182,0,35,0
1710871756,185,167,167,177,0,18,0
1710875171,185,158,159,176,0,26,1
1710878858,185,150,151,175,0,34,1
1710882367,185,151,155,173,0,30,4
1710885987,185,150,153,174,0,32,3
1710889660,185,147,151,173,0,34,4
1710894830,185,149,152,173,0,33,3
1710898746,185,147,149,174,0,36,2
1710900813,185,150,151,175,0,34,1
1710904089,185,151,153,174,0,32,2
1710907763,185,154,155,175,0,30,1
1710911285,185,158,159,176,0,26,1
1710914963,185,163,165,175,0,20,2
1710918527,185,144,146,176,0,39,2
1710922154,185,143,143,178,0,42,0
1710925655,185,135,138,173,0,47,3
1710929249,185,152,152,173,0,33,0
1710932781,185,151,152,174,0,33,1
1710936754,185,152,154,176,0,31,2
1710940171,185,155,157,176,0,28,2
1710943617,185,151,151,177,0,34,0
1710947217,185,156,157,175,0,28,1
1710951010,185,159,160,180,0,25,1
1710954338,185,154,154,181,0,31,0
1710958128,185,156,156,179,0,29,0
1710961538,185,162,162,176,0,23,0
1710965282,185,163,164,175,0,21,1
1710968841,185,156,156,177,0,29,0
1710972365,185,154,155,177,0,30,1
1710976102,185,161,162,177,0,23,1
1710981312,185,157,157,178,0,28,0
1710985242,185,155,156,177,0,29,1
1710987347,185,157,158,177,0,27,1
1710990562,185,155,156,177,0,29,1
1710994177,185,157,159,176,0,26,2
1710997636,185,158,160,176,0,25,2
1711001371,185,158,159,176,0,26,1
1711004855,185,165,165,173,0,20,0
1711008547,185,146,146,171,0,39,0
1711012018,185,139,140,171,0,45,1
1711015623,185,148,149,170,0,36,1
1711019202,185,144,145,170,0,40,1
1711023138,185,158,158,174,0,27,0
1711026487,185,153,155,172,0,30,2
1711030025,185,157,160,170,0,25,3
1711033688,185,153,155,174,0,30,2
1711037410,185,149,149,180,0,36,0
1711040802,185,159,159,179,0,26,0
1711044557,185,155,157,177,0,28,2
1711047973,185,156,156,175,0,29,0
1711051691,185,166,166,174,0,19,0
1711055282,185,165,166,174,0,19,1
1711058785,185,155,156,175,0,29,1
1711062481,185,157,158,174,0,27,1
1711067625,185,151,153,173,0,32,2
1711071538,185,145,148,171,0,37,3
1711073615,185,150,151,172,0,34,1
1711076857,185,152,152,173,0,33,0
1711080532,185,156,157,173,0,28,1
1711084086,185,163,164,173,0,21,1
1711087761,185,160,163,173,0,22,3
1711091258,185,151,152,173,0,33,1
1711094976,185,144,148,172,0,37,4
1711098537,185,151,151,173,0,34,0
1711102020,185,146,147,172,0,38,1
1711105567,185,136,136,175,0,49,0
1711109594,185,152,153,174,0,32,1
1711112793,185,147,149,172,0,36,2
1711116426,185,148,154,174,0,31,6
1711120023,185,149,150,177,0,35,1
1711123781,185,159,160,179,0,25,1
1711127171,185,151,151,180,0,34,0
1711130953,185,156,157,181,0,28,1
1711134389,185,159,160,178,0,25,1
1711138035,185,149,150,178,0,35,1
1711141622,185,150,151,179,0,34,1
1711145179,185,159,159,180,0,26,0
1711148797,185,159,160,181,0,25,1
1711153971,185,154,157,177,0,28,3
1711157830,185,151,154,176,0,31,3
1711160018,185,153,157,176,0,28,4
1711163342,185,152,155,178,0,30,3
1711166946,185,154,156,178,0,29,2
1711170444,185,159,162,177,0,23,3
1711174337,185,159,161,178,0,24,2
1711177684,185,161,162,176,0,23,1
1711181282,185,156,157,175,0,28,1
1711184840,185,147,150,176,0,35,3
1711188449,185,146,147,176,0,38,1
1711191890,185,147,147,177,0,38,0
1711195976,185,144,144,179,0,41,0
1711199174,185,140,142,177,0,43,2
1711202741,185,134,134,176,0,51,0
1711206520,185,141,141,173,0,44,0
1711210056,185,149,149,174,0,36,0
1711213596,185,145,148,175,0,37,3
1711217293,185,157,158,181,0,27,1
1711220733,185,151,152,180,0,33,1
1711224480,185,148,150,177,0,35,2
1711227944,185,148,150,177,0,35,2
1711231620,185,149,151,178,0,34,2
1711235175,185,154,156,180,0,29,2
1711240691,185,146,149,180,0,36,3
1711244730,185,148,151,178,0,34,3
1711246691,185,148,151,178,0,34,3
